25x25;13x13
     ϓϓϓ        ɅɅɅɅɅɅɅɅɅ
    ϓϓϓϓϓ         ɅɅɅɅɅɅɅ
     ϓϓ2           ɅɅɅɅɅɅ
                   ɅɅɅɅɅɅ
                   ≈ ɅɅɅɅ
                   ≈  Ʌ Ʌ
                  ≈≈     
          ϓ       ≈      
                  ≈      
    ≈            ≈≈      
  ≈≈≈≈           1       
  ≈≈≈≈≈         ≈≈       
 ≈≈≈≈≈≈     0   ≈        
  ≈≈≈≈≈         ≈        
  ≈≈≈≈          ≈≈       
   ≈≈≈≈          ≈≈      
      ≈≈          ≈      
       ≈          ≈≈   ϓ 
  ϓ    ≈≈          ≈≈ϓ ϓϓ
        ≈≈          ≈≈ϓϓϓ
         ≈        ϓϓϓ≈≈ϓϓ
         ≈≈     ϓϓϓϓϓϓ≈ϓϓ
   ⌂      ≈≈   ϓ ϓϓϓ≈ϓ≈≈ϓ
           ≈    ϓϓϓϓϓϓ ≈ϓ
           ≈  ϓ ϓϓϓϓϓϓϓ≈ϓ
Water,≈,≈,true;Mountain,Ʌ,Ʌ,true;MapChange,1,Bridge.map,⌂,false,ToCoord,3x5;MapChange,2,House.map,⌂,false,ToCoord,8x12